************
*          *
*$*        *
* **$****  *
*   **     *
*          *
*****@******
*$       *$*
*****   ** *
*$** *  *  *
*         $*
************