************
*    ***   *
*     @    *
* **    $***
*$      $  *
**	*  *
****    *$**
*$$*	$* *
*$**	* **
* **    *  *
*     *    *
************